"filename", "language", "Java", "Markdown", "comment", "blank", "total"
"c:\Users\edwardo contreras\Desktop\Programs\Java\Mario\server\README.md", "Markdown", 0, 10, 0, 9, 19
"c:\Users\edwardo contreras\Desktop\Programs\Java\Mario\server\bin\Client$1.class", "Java", 14, 0, 0, 0, 14
"c:\Users\edwardo contreras\Desktop\Programs\Java\Mario\server\bin\Client.class", "Java", 42, 0, 0, 0, 42
"c:\Users\edwardo contreras\Desktop\Programs\Java\Mario\server\bin\ClientHandler.class", "Java", 43, 0, 0, 0, 43
"c:\Users\edwardo contreras\Desktop\Programs\Java\Mario\server\bin\personaje.class", "Java", 8, 0, 0, 0, 8
"c:\Users\edwardo contreras\Desktop\Programs\Java\Mario\server\bin\server.class", "Java", 30, 0, 0, 0, 30
"c:\Users\edwardo contreras\Desktop\Programs\Java\Mario\server\src\Client.java", "Java", 81, 0, 3, 18, 102
"c:\Users\edwardo contreras\Desktop\Programs\Java\Mario\server\src\ClientHandler.java", "Java", 73, 0, 0, 10, 83
"c:\Users\edwardo contreras\Desktop\Programs\Java\Mario\server\src\personaje.java", "Java", 9, 0, 0, 4, 13
"c:\Users\edwardo contreras\Desktop\Programs\Java\Mario\server\src\server.java", "Java", 34, 0, 4, 8, 46
"c:\Users\edwardo contreras\Desktop\Programs\Java\Mario\src\audio\AudioManager.java", "Java", 118, 0, 0, 28, 146
"c:\Users\edwardo contreras\Desktop\Programs\Java\Mario\src\clasesInstanciables\Enemigos\Bowser.java", "Java", 173, 0, 5, 43, 221
"c:\Users\edwardo contreras\Desktop\Programs\Java\Mario\src\clasesInstanciables\Enemigos\BowserFireball.java", "Java", 69, 0, 0, 18, 87
"c:\Users\edwardo contreras\Desktop\Programs\Java\Mario\src\clasesInstanciables\Enemigos\Enemigo.java", "Java", 107, 0, 2, 40, 149
"c:\Users\edwardo contreras\Desktop\Programs\Java\Mario\src\clasesInstanciables\Enemigos\Goomba.java", "Java", 81, 0, 1, 21, 103
"c:\Users\edwardo contreras\Desktop\Programs\Java\Mario\src\clasesInstanciables\Enemigos\Koopa.java", "Java", 102, 0, 1, 24, 127
"c:\Users\edwardo contreras\Desktop\Programs\Java\Mario\src\clasesInstanciables\Enemigos\KoopaVolador.java", "Java", 21, 0, 1, 10, 32
"c:\Users\edwardo contreras\Desktop\Programs\Java\Mario\src\clasesInstanciables\Entidad.java", "Java", 153, 0, 6, 50, 209
"c:\Users\edwardo contreras\Desktop\Programs\Java\Mario\src\clasesInstanciables\EntityManager.java", "Java", 303, 0, 4, 68, 375
"c:\Users\edwardo contreras\Desktop\Programs\Java\Mario\src\clasesInstanciables\Jugador\FuegoProyectil.java", "Java", 79, 0, 0, 25, 104
"c:\Users\edwardo contreras\Desktop\Programs\Java\Mario\src\clasesInstanciables\Jugador\Personaje.java", "Java", 433, 0, 47, 133, 613
"c:\Users\edwardo contreras\Desktop\Programs\Java\Mario\src\clasesInstanciables\Spawner.java", "Java", 26, 0, 0, 14, 40
"c:\Users\edwardo contreras\Desktop\Programs\Java\Mario\src\clasesInstanciables\recolectables\PowerUps\BloqueMisterioso.java", "Java", 76, 0, 0, 17, 93
"c:\Users\edwardo contreras\Desktop\Programs\Java\Mario\src\clasesInstanciables\recolectables\PowerUps\FlorFuego.java", "Java", 41, 0, 0, 11, 52
"c:\Users\edwardo contreras\Desktop\Programs\Java\Mario\src\clasesInstanciables\recolectables\PowerUps\Hongo.java", "Java", 41, 0, 0, 12, 53
"c:\Users\edwardo contreras\Desktop\Programs\Java\Mario\src\clasesInstanciables\recolectables\PowerUps\HongoEnvenenado.java", "Java", 41, 0, 1, 12, 54
"c:\Users\edwardo contreras\Desktop\Programs\Java\Mario\src\clasesInstanciables\recolectables\PowerUps\Moneda.java", "Java", 45, 0, 0, 14, 59
"c:\Users\edwardo contreras\Desktop\Programs\Java\Mario\src\clasesInstanciables\recolectables\PowerUps\Star.java", "Java", 54, 0, 0, 15, 69
"c:\Users\edwardo contreras\Desktop\Programs\Java\Mario\src\clasesInstanciables\recolectables\Recolectable.java", "Java", 22, 0, 0, 11, 33
"c:\Users\edwardo contreras\Desktop\Programs\Java\Mario\src\constantes\Constantes.java", "Java", 103, 0, 2, 33, 138
"c:\Users\edwardo contreras\Desktop\Programs\Java\Mario\src\databases\ArchivoSerializable.java", "Java", 138, 0, 9, 30, 177
"c:\Users\edwardo contreras\Desktop\Programs\Java\Mario\src\databases\Database.java", "Java", 47, 0, 5, 14, 66
"c:\Users\edwardo contreras\Desktop\Programs\Java\Mario\src\databases\Sesion.java", "Java", 26, 0, 4, 10, 40
"c:\Users\edwardo contreras\Desktop\Programs\Java\Mario\src\databases\Usuario.java", "Java", 86, 0, 8, 29, 123
"c:\Users\edwardo contreras\Desktop\Programs\Java\Mario\src\game\Game.java", "Java", 17, 0, 3, 8, 28
"c:\Users\edwardo contreras\Desktop\Programs\Java\Mario\src\graficos\GamePanel.class", "Java", 11, 0, 0, 0, 11
"c:\Users\edwardo contreras\Desktop\Programs\Java\Mario\src\graficos\GamePanel.java", "Java", 197, 0, 7, 66, 270
"c:\Users\edwardo contreras\Desktop\Programs\Java\Mario\src\graficos\Gui.java", "Java", 114, 0, 31, 34, 179
"c:\Users\edwardo contreras\Desktop\Programs\Java\Mario\src\graficos\HUD.java", "Java", 92, 0, 0, 32, 124
"c:\Users\edwardo contreras\Desktop\Programs\Java\Mario\src\graficos\MenuPanel.java", "Java", 37, 0, 6, 20, 63
"c:\Users\edwardo contreras\Desktop\Programs\Java\Mario\src\graficos\pantallas\InicioSesion.java", "Java", 93, 0, 11, 31, 135
"c:\Users\edwardo contreras\Desktop\Programs\Java\Mario\src\graficos\pantallas\MenuPrincipal.java", "Java", 141, 0, 11, 52, 204
"c:\Users\edwardo contreras\Desktop\Programs\Java\Mario\src\graficos\pantallas\Registro.java", "Java", 124, 0, 11, 40, 175
"c:\Users\edwardo contreras\Desktop\Programs\Java\Mario\src\inputs\InptutMouse.java", "Java", 33, 0, 1, 19, 53
"c:\Users\edwardo contreras\Desktop\Programs\Java\Mario\src\inputs\InputTeclado.java", "Java", 85, 0, 3, 25, 113
"c:\Users\edwardo contreras\Desktop\Programs\Java\Mario\src\interfaces\Identificable.java", "Java", 4, 0, 0, 4, 8
"c:\Users\edwardo contreras\Desktop\Programs\Java\Mario\src\networking\PlayerInput.java", "Java", 15, 0, 0, 5, 20
"c:\Users\edwardo contreras\Desktop\Programs\Java\Mario\src\niveles\Level.java", "Java", 108, 0, 2, 35, 145
"c:\Users\edwardo contreras\Desktop\Programs\Java\Mario\src\niveles\LevelManager.java", "Java", 81, 0, 1, 27, 109
"c:\Users\edwardo contreras\Desktop\Programs\Java\Mario\src\utils\HelpMethods.java", "Java", 39, 0, 0, 20, 59
"c:\Users\edwardo contreras\Desktop\Programs\Java\Mario\src\utils\LoadSave.java", "Java", 71, 0, 0, 17, 88
"Total", "-", 3981, 10, 190, 1166, 5347